1,1,1,1,1,1,1,1,1,1,1,1,1,1,1,1,1,1
1,0,0,0,0,0,0,{*}{}{*(0;0)(1;1)(1;-1)(-1;1)(-1;-1)},0,0,0,0,0,0,0,0,0,1
1,0,0,0,0,0,0,0,0,0,0,0,0,0,0,0,0,1
1,0,0,0,0,2,2,0,0,0,0,0,2,{}{2},0,0,0,1
1,0,0,0,0,2,2,0,0,0,0,0,0,0,0,0,0,1
1,0,0,X,0,0,0,0,0,0,0,0,{+}{3},0,0,Y0,0,1
1,0,0,0,0,0,0,0,0,0,0,0,0,0,0,0,0,1
1,0,0,0,0,0,0,0,0,0,0,2,2,0,0,0,0,1
1,0,0,0,0,0,0,0,0,0,0,0,Y1,0,0,0,0,1
1,0,0,0,0,0,0,0,0,0,0,0,0,0,0,0,0,1
1,1,1,1,1,1,1,1,1,1,1,1,1,1,1,1,1,1
