1,1,1,1,1,1,1,1,1,1,1,1,1,1,1,1,1,1
1,0,0,0,0,0,0,0,0,0,0,0,0,0,0,0,0,1
1,0,2,2,0,0,0,0,0,0,0,0,0,0,2,2,0,1
1,0,2,2,0,0,0,0,0,0,0,0,Y2,0,2,2,0,1
1,0,0,0,0,0,0,0,0,0,0,Y0,0,0,0,0,0,1
1,0,0,X,0,0,{/}{}{/(0;0)(1;1)(-1;1)(2;2)(-2;2)},0,{}{1},0,0,0,0,0,0,0,0,1
1,0,0,0,0,0,0,0,0,0,0,Y1,0,0,0,0,0,1
1,0,2,2,0,0,0,0,0,0,0,0,Y3,0,2,2,0,1
1,0,2,2,0,0,0,0,0,0,0,0,0,0,2,2,0,1
1,0,0,0,0,0,0,0,0,0,0,0,0,0,0,0,0,1
1,1,1,1,1,1,1,1,1,1,1,1,1,1,1,1,1,1
