1,1,1,1,1,1,1,1,1,1,1,1,1,1,1,1,1,1
1,0,0,0,0,0,0,0,0,0,0,0,0,0,0,0,0,1
1,0,0,0,0,(6;0),0,0,0,3,3,0,3,3,3,0,0,1
1,0,0,0,0,0,3,0,0,0,0,0,3,Y0,3,0,0,1
1,0,0,0,0,0,0,{}{3},0,0,0,0,3,3,3,0,0,1
1,0,0,X,0,0,0,0,0,0,0,0,0,0,0,0,0,1
1,0,0,0,0,0,0,0,0,{+}{}{+(0;0)},0,0,0,0,{}{2},0,0,1
1,0,0,0,3,0,0,0,0,3,0,0,0,3,0,0,0,1
1,0,0,0,0,{*}{}{*(0;0)(1;1)(1;-1)(-1;1)(-1;-1)},0,0,0,0,0,(-2;3),0,0,0,0,0,1
1,0,0,0,0,0,0,0,0,0,0,0,0,0,0,0,0,1
1,1,1,1,1,1,1,1,1,1,1,1,1,1,1,1,1,1
